-------------------n
-------------------n
---m---------------n
-------------------n
-------------------n
-------------------n
-------------------n
-------------------n
-------------------n
-------x-----------n
-dd------x---------n
----------------x--n
------------x------n
-----xxxxxxxxn
