-------------------n
-------------------n
---m---------------n
-------------------n
-------------------n
-------------------n
-------------------n
-------------------n
-------------------n
x------x-----------n
xddddddx-x---------n
----------xxx---x--n
---------------x---n
-@---------xxxxxxxxn
