m-B----------------n
ffB----------------n
---p-x----[-m-x----n
ffffffffffffffffffBn
--------------dd---n
^-----------------xn
---m--x--}---x---xxn
fpfffffffffffffffffn
-------------------n
-------------------n
-~----x--{--x--m---n
ffffffffffffffff---n
------------B-----xn
@-----------B----pxn