------------------mn
----------x--------n
BBBBBBBB--x--------n
--v------^x--------n
----------x--p-----n
BB--BBBBBBfBBffffffn
----------d--------n
ffffffffffffffBBBBBn
--------B-----f----n
--------B--------ffn
--------xxx-----f--n
-------xx---ff-f---n
-----xxxx----------n
~-@pppppp-x-----[--n
