--Dfp--mBfBm--pfD--n
--f--p---f---p--f--n
-fBBBpppBfBpppBBBf-n
--B------B------B--n
f-p>-----B-----<p-fn
fBpppfffffffffpppBfn
-------------------n
------~--@---D-----n
fpBBBfffffffffBBBpfn
--B------p------B--n
--p{-----p-----}p--n
-fpppBBBBxBBBBpppf-n
--f--B---x---B--f--n
f-!fB!-mpxpm-!Bf!-fn