--Dfp--mBfBm--pfD--n
--f--p---f---p--f--n
-fBBBBppBfBppBBBBf-n
--B------B------B--n
f-p>-----B-----<p-fn
fBpppfffffffffpppBfn
-------------------n
------~--@---D-----n
fpBBBfffffffffBBBpfn
--B------p------B--n
--p{-----p-----}p--n
-fppppBBBxBBBppppf-n
--f--B---x---B--f--n
f-!fB!-mpxpm-!Bf!-fn