-----------------pmn
-@---------------ppn
xxxxxxxxxxxxxxx----n
--^-----------vxx--n
---xx------------x-n
---xx--------------n
---xx-{--x---------n
---xxxxxxxxxx------n
---xx--------x----^n
---xx--------------n
--xxx--xxxxxxxx----n
---xx--------------n
---xxxx------------n
m-dxx---xxxxxxx----n
