------------------mn
--------------f-fffn
---------f-f-f-----n
ff----ff-----------n
--ff-------------m-n
----ff-ffffffff--f-n
----------------f--n
---------------f---n
--------------f----n
--~@-------f-f-----n
pffff-f-ff---------n
--BBBBBBBBBBBBBBBBBn
-------------------n
DDDDDDDDDDDDDDDDDDDn