------------------mn
----------------fffn
---------f-f-ff----n
----f-ff-----------n
ff---------------m-n
--ff---------------n
----ff-ffffffff---fn
-----------------f-n
!!!----------------n
--!@-------f-fff---n
pffff-f-ff---------n
--BBBBBBBBBBBBBBBBBn
-------------------n
DDDDDDDDDDDDDDDDDDDn