---------m---------n
----<-->----->-----n
---------<--><-----n
----->---<---<-----n
--->----<-->-------n
-->--<-------------n
--<-------->-------n
-->----------<-----n
-------->----<-----n
-<----------->-----n
-------->----<-----n
-------<----->-----n
-------------------n
----------@------ddn