----------v--------n
xx--{-x-------m----n
--ffffff-----ffff--n
-------------------n
----@--------------n
xxxxxxxx~~~~~~~xxxxn
--------x-------x--n
--------x-------xx--n
--------xdddddddx--n
--------fffffffff--n
-------------------n
-------------------n
-------------------n
-------------------n
