dddddddddddddddddddn
---m---------------n
--------g----------n
-------------------n
--p-------------p--n
-----------------p-n
--------~---!----m-n
-------f-f-f-f-f-f-n
-------------------n
--^------------v---n
--------------x--[-n
-----------df-ffff-n
-----------ff----f-n
D---@--xx-{---xx---n