m-!----------------n
ff!----------------n
---p-x----[-m-x----n
ffffffffffffffffff!n
-------------------n
^-----------------xn
---m--x--}---x-D-xxn
fpfffffffffffffffffn
-------------------n
-------------------n
-~----x--{--x--m---n
ffffffffffffffff---n
------------B-----xn
@-----------B----pxn
