----------v--------n
xx--{-x-------m----n
--ffffff-----ffff--n
-------------------n
----@--------------n
xxxxx-~~~~~~~--xx--n
--------x-------x--n
---------x-------x--n
--------x--dddd-x--n
------------fffff--n
-------------------n
-------------------n
-------------------n
-------------------n
