-------------------n
~~-----------------n
mx---[----m--x--!--n
ffffffffffffffffff~n
-------------------n
^-----------------xn
---m--x--}---x---xxn
fpfffffffffffffffffn
-------------------n
-------------------n
------x--{--x--m---n
fffffffffffffffff--n
------------------xn
@----------------xxn
