-------------------n
-------------------n
-------------------n
---------f---------n
----------f--------n
-----------f-------n
------------x------n
ffffffffffffffBBBBBn
--------B------f---n
--------B---------fn
--------xxx----f---n
-------xx----f-----n
-----xxxx----------n
~-@pppppp-x-----[--n
