------------------mn
----------x--------n
BBBBBBBB--x--------n
--v------^x--------n
----------x--p-----n
BB--BBBBBBfBBffffffn
--------d-B--------n
ffffffffffffffBBBBBn
--------B-----f----n
--------B--------ffn
--------xxx--------n
-------xx---f--f---n
-----xxxx----------n
~-@pppppp-x-----[--n
