-------------------n
-------------------n
---m---------------n
-------------------n
-------------------n
-------------------n
-------------------n
-------------------n
-------------------n
x------x-----------n
fddddddf-f---------n
----------fff---f--n
---------------f---n
-@---------xxxxxxxxn
