m-!----x-----x-mx-mn
xx!--xxx--x--x--x--n
~----B----x--xpppxpn
xxxxxxxxxxx--x---x-n
----------------B--n
---xxxxxxxxxxxxxxx-n
-----------------x-n
-------------------n
-------------------n
-------------------n
-------------------n
-------------------n
-------------------n
-------------------n
